# must end every line will comma parsing must end with ,

# Player init is ( stageID , x , y )
P
0,6,2,

S
0,_,_,_,_,_,_,_,_,_,
_,g,g,g,g,g,g,g,g,_,
_,_,g,g,g,b,g,g,g,_,
_,_,g,g,g,g,g,g,g,_,
_,_,_,g,g,g,g,g,g,_,
_,_,_,_,g,g,g,g,g,_,
_,_,_,_,_,g,g,g,_,_,
_,_,_,_,_,_,f,_,_,_,
_,_,_,_,_,_,f,_,_,_,
_,_,_,_,_,_,1,_,_,_,

END

S
1,_,_,_,_,_,0,_,_,_,
_,_,f,f,k,_,f,_,_,_,
_,_,f,_,_,_,f,_,_,_,
_,_,f,_,f,f,f,_,_,_,
_,_,f,f,f,_,_,_,_,_,
_,_,d,_,_,_,_,_,_,_,
_,_,f,f,_,_,_,_,_,_,
_,_,_,f,_,_,_,_,_,_,
_,_,_,f,_,_,_,_,_,_,
_,_,_,2,_,_,_,_,_,_,

S
2,_,_,1,_,_,_,_,_,_,
_,_,_,f,_,_,_,_,_,_,
_,_,_,f,f,f,f,_,_,_,
_,_,_,_,_,_,f,_,_,_,
3,f,d,f,f,f,f,d,f,5,
_,_,_,f,_,_,_,_,_,_,
_,_,_,f,_,_,_,_,_,_,
_,k,f,f,f,d,f,_,_,_,
_,_,_,_,_,_,f,_,_,_,
_,_,_,_,_,_,8,_,_,_,

S
3,_,_,_,_,_,_,_,_,_,
_,4,f,_,_,_,_,_,_,_,
_,_,f,_,f,f,f,f,_,_,
_,_,f,f,f,f,f,f,_,_,
_,_,f,f,f,f,f,f,f,2,
_,_,f,f,f,k,f,f,_,_,
_,_,f,f,f,f,f,f,_,_,
_,_,_,_,_,_,_,_,_,_,
_,_,_,_,_,_,_,_,_,_,
_,_,_,_,_,_,_,_,_,_,

E
3
3,3,
3,4,
4,4,
4,5,
3,5,
3,6,
4,6,
5,6,
6,6,
6,5,
5,5,
5,4,
6,4,
6,3,
5,3,
4,3,
e

E
3
5,6,
6,6,
6,5,
5,5,
5,4,
6,4,
6,3,
5,3,
4,3,
3,3,
3,4,
4,4,
4,5,
3,5,
3,6,
4,6,
e


S
4,_,_,_,_,_,_,_,_,_,
_,3,f,_,_,f,_,_,_,_,
_,f,f,f,f,f,f,f,_,_,
_,_,f,_,_,_,_,f,_,_,
_,f,f,_,k,f,_,f,_,_,
_,_,f,_,f,G,d,f,f,_,
_,_,f,_,_,_,_,f,_,_,
_,_,f,f,f,f,f,f,_,_,
_,_,_,_,f,_,_,_,_,_,
_,_,_,_,_,_,_,_,_,_,

E
4
2,2,
2,3,
2,4,
2,5,
2,6,
2,7,
3,7,
4,7,
5,7,
6,7,
7,7,
7,6,
7,5,
7,4,
7,3,
7,2,
6,2,
5,2,
4,2,
3,2,
e

E
4
2,7,
3,7,
4,7,
5,7,
6,7,
7,7,
7,6,
7,5,
7,4,
7,3,
7,2,
6,2,
5,2,
4,2,
3,2,
2,2,
2,3,
2,4,
2,5,
2,6,
e

E
4
7,7,
7,6,
7,5,
7,4,
7,3,
7,2,
6,2,
5,2,
4,2,
3,2,
2,2,
2,3,
2,4,
2,5,
2,6,
2,7,
3,7,
4,7,
5,7,
6,7,
e

E
4
7,2,
6,2,
5,2,
4,2,
3,2,
2,2,
2,3,
2,4,
2,5,
2,6,
2,7,
3,7,
4,7,
5,7,
6,7,
7,7,
7,6,
7,5,
7,4,
7,3,
7,2,
e

S
5,_,_,_,_,_,_,_,_,_,
_,_,_,_,_,k,f,f,_,_,
_,_,f,f,f,_,_,f,_,_,
_,_,f,_,f,_,f,f,_,_,
2,f,f,_,f,_,f,f,_,_,
_,_,_,_,r,_,f,f,f,6,
_,_,f,r,r,_,f,f,_,_,
_,_,f,_,_,_,f,_,_,_,
_,_,f,f,f,f,f,_,_,_,
_,_,_,_,_,_,_,_,_,_,

E
5
6,1,
7,1,
7,2,
7,3,
6,3,
6,4,
6,3,
7,3,
7,2,
7,1,
e

S
6,_,_,_,_,_,_,_,_,_,
_,_,_,_,_,_,_,_,_,_,
_,_,_,_,k,f,f,f,f,7,
_,_,_,_,f,_,_,_,_,_,
_,_,_,_,T,_,_,_,_,_,
5,f,f,d,f,f,n,f,f,7,
_,_,f,_,_,_,_,_,_,_,
_,_,f,f,f,f,f,k,_,_,
_,_,_,_,_,_,_,_,_,_,
_,_,_,_,_,_,_,_,_,_,

S
7,_,_,_,_,_,_,_,_,_,
_,f,f,f,f,f,f,t,f,_,
6,f,_,_,_,_,_,_,f,_,
_,_,f,_,f,_,f,_,f,_,
_,_,f,_,f,_,f,_,f,_,
6,f,f,f,f,f,f,G,f,_,
_,_,f,_,f,_,f,_,_,_,
_,_,f,_,f,_,f,_,_,_,
_,_,_,_,_,_,_,_,_,_,
_,_,_,_,_,_,_,_,_,_,

E
7
2,3,
2,4,
2,5,
2,6,
2,7,
2,6,
2,5,
2,4,
e

E
7
4,7,
4,6,
4,5,
4,4,
4,3,
4,4,
4,5,
4,6,
e

E
7
6,3,
6,4,
6,5,
6,6,
6,7,
6,6,
6,5,
6,4,
e


S
8,_,_,_,_,_,2,_,_,_,
_,_,_,_,_,_,f,_,_,_,
_,_,f,k,f,f,f,_,_,_,
_,_,_,_,_,_,d,_,_,_,
_,_,f,f,f,f,f,_,_,_,
_,_,f,_,_,_,f,_,_,_,
_,_,f,_,_,_,f,f,f,9,
_,_,t,_,_,_,_,_,_,_,
_,_,_,_,_,_,_,_,_,_,
_,_,_,_,_,_,_,_,_,_,

E
8
2,2,
3,2,
4,2,
5,2,
6,2,
5,2,
4,2,
3,2,
e

S
9,_,_,_,_,_,_,_,_,_,
_,_,k,f,f,_,_,G,_,_,
_,_,_,_,f,_,_,_,_,_,
_,_,_,r,r,r,_,T,_,_,
_,_,_,r,_,d,_,f,_,_,
_,_,_,r,_,f,_,f,f,_,
8,f,f,r,_,f,_,k,f,_,
_,_,_,_,_,f,r,f,f,_,
_,_,_,_,_,_,_,_,_,_,
_,_,_,_,_,_,_,_,_,_,

E
9
8,6,
8,5,
7,5,
7,6,
e

END
  


S
1,_,_,_,_,_,_,_,_,_,
_,_,_,_,_,_,_,_,_,_,
_,_,_,_,_,_,_,_,_,_,
_,_,_,_,_,_,_,_,_,_,
_,_,_,_,_,_,_,_,_,_,
_,_,_,_,_,_,_,_,_,_,
_,_,_,_,_,_,_,_,_,_,
_,_,_,_,_,_,_,_,_,_,
_,_,_,_,_,_,_,_,_,_,
_,_,_,_,_,_,_,_,_,_,